4 5 4 5 4 5 4 5 4 5 4 5 4 5 4 5 4 5 4 5 4 5 4 5 4 5 4 5 4 5 4 5 4 5 4 5 4 5 4 5 4 5 4 5 4 5 4 5 4 5
6 7 6 7 6 7 6 7 6 7 6 7 6 7 6 7 6 7 6 7 6 7 6 7 6 7 6 7 6 7 6 7 6 7 6 7 6 7 6 7 6 7 6 7 6 7 6 7 6 7 
4 5 4 5 4 5 4 5 4 5 4 5 4 5 4 5 4 5 4 5 4 5 4 5 4 5 4 5 4 5 4 5 4 5 4 5 4 5 4 5 4 5 4 5 4 5 4 5 4 5
6 7 6 7 6 7 6 7 6 7 6 7 6 7 6 7 6 7 6 7 6 7 6 7 6 7 6 7 6 7 6 7 6 7 6 7 6 7 6 7 6 7 6 7 6 7 6 7 6 7 
4 5 4 5 4 5 4 5 4 5 4 5 4 5 4 5 4 5 4 5 4 5 4 5 4 5 4 5 4 5 4 5 4 5 4 5 4 5 4 5 4 5 4 5 4 5 4 5 4 5
6 7 6 7 6 7 6 7 6 7 6 7 6 7 6 7 6 7 6 7 6 7 6 7 6 7 6 7 6 7 6 7 6 7 6 7 6 7 6 7 6 7 6 7 6 7 6 7 6 7 
4 5 4 5 4 5 4 5 4 5 4 5 4 5 4 5 4 5 4 5 4 5 4 5 4 5 4 5 4 5 4 5 4 5 4 5 4 5 4 5 4 5 4 5 4 5 4 5 4 5
6 7 6 7 6 7 6 7 6 7 6 7 6 7 6 7 6 7 6 7 6 7 6 7 6 7 6 7 6 7 6 7 6 7 6 7 6 7 6 7 6 7 6 7 6 7 6 7 6 7 
4 5 4 5 4 5 4 5 4 5 4 5 4 5 4 5 4 5 4 5 4 5 4 5 4 5 4 5 4 5 4 5 4 5 4 5 4 5 4 5 4 5 4 5 4 5 4 5 4 5
6 7 6 7 6 7 6 7 6 7 6 7 6 7 6 7 6 7 6 7 6 7 6 7 6 7 6 7 6 7 6 7 6 7 6 7 6 7 6 7 6 7 6 7 6 7 6 7 6 7 
4 5 4 5 4 5 4 5 4 5 4 5 0 0 0 0 0 0 0 0 0 0 0 0 3 3 0 0 0 0 0 0 0 0 0 0 0 0 4 5 4 5 4 5 4 5 4 5 4 5 
6 7 6 7 6 7 6 7 6 7 6 7 0 1 1 1 1 1 1 0 0 0 0 0 3 3 0 0 0 0 0 0 0 0 0 0 0 0 6 7 6 7 6 7 6 7 6 7 6 7
4 5 4 5 4 5 4 5 4 5 4 5 0 1 3 3 3 3 1 0 0 4 5 0 3 3 0 0 3 3 3 3 3 3 3 3 0 0 4 5 4 5 4 5 4 5 4 5 4 5 
6 7 6 7 6 7 6 7 6 7 6 7 0 1 3 3 3 3 1 0 0 6 7 0 3 3 0 0 3 2 2 2 2 2 2 3 0 0 6 7 6 7 6 7 6 7 6 7 6 7
4 5 4 5 4 5 4 5 4 5 4 5 0 1 3 3 3 3 1 0 0 0 0 0 3 3 0 0 3 2 2 2 2 2 2 3 0 0 4 5 4 5 4 5 4 5 4 5 4 5 
6 7 6 7 6 7 6 7 6 7 6 7 0 1 3 3 3 3 1 0 0 0 0 0 3 3 0 0 3 2 2 2 2 2 2 3 0 0 6 7 6 7 6 7 6 7 6 7 6 7
4 5 4 5 4 5 4 5 4 5 4 5 0 1 1 3 3 1 1 0 0 0 0 0 3 3 0 0 3 2 2 2 2 2 2 3 0 0 4 5 4 5 4 5 4 5 4 5 4 5 
6 7 6 7 6 7 6 7 6 7 6 7 0 0 0 3 3 0 0 0 0 0 0 0 3 3 0 0 3 2 2 2 2 2 2 3 0 0 6 7 6 7 6 7 6 7 6 7 6 7
4 5 4 5 4 5 4 5 4 5 4 5 0 0 0 3 3 0 4 5 0 0 0 0 3 3 0 0 3 2 2 2 2 2 2 3 0 0 4 5 4 5 4 5 4 5 4 5 4 5 
6 7 6 7 6 7 6 7 6 7 6 7 0 0 0 3 3 0 6 7 0 0 0 0 3 3 0 0 3 2 2 2 2 2 2 3 0 0 6 7 6 7 6 7 6 7 6 7 6 7
4 5 4 5 4 5 4 5 4 5 4 5 0 0 0 3 3 0 0 0 0 0 0 0 3 3 0 0 3 2 2 2 2 2 2 3 0 0 4 5 4 5 4 5 4 5 4 5 4 5 
6 7 6 7 6 7 6 7 6 7 6 7 0 0 0 3 3 0 0 0 0 4 5 0 3 3 0 0 3 3 3 3 3 3 3 3 0 0 6 7 6 7 6 7 6 7 6 7 6 7
4 5 4 5 4 5 4 5 4 5 4 5 0 0 0 3 3 0 0 0 0 6 7 0 3 3 0 0 0 0 0 0 0 0 0 0 0 0 4 5 4 5 4 5 4 5 4 5 4 5 
6 7 6 7 6 7 6 7 6 7 6 7 0 0 0 3 3 0 0 0 0 0 0 0 3 3 0 0 0 0 0 0 0 0 0 0 0 0 6 7 6 7 6 7 6 7 6 7 6 7
4 5 4 5 4 5 4 5 4 5 4 5 3 3 3 3 3 3 3 3 3 3 3 3 3 3 3 3 3 3 3 3 3 3 3 3 3 3 4 5 4 5 4 5 4 5 4 5 4 5 
6 7 6 7 6 7 6 7 6 7 6 7 3 3 3 3 3 3 3 3 3 3 3 3 3 3 3 3 3 3 3 3 3 3 3 3 3 3 6 7 6 7 6 7 6 7 6 7 6 7
4 5 4 5 4 5 4 5 4 5 4 5 0 0 0 0 0 0 0 0 0 0 0 0 3 3 0 0 0 0 0 0 0 0 0 0 0 0 4 5 4 5 4 5 4 5 4 5 4 5 
6 7 6 7 6 7 6 7 6 7 6 7 0  1 1 0 3 3 0 0 0 0 0 0 0 0 0 0 0 0 6 7 6 7 6 7 6 7 6 7 6 7
4 5 4 5 4 5 4 5 4 5 4 5 0 0 0 0 0 0 0 0 0 0 1 0 3 3 0 0 0 0 4 5 4 5 4 5 4 5 4 5 4 5 4 5 4 5 4 5 4 5 
6 7 6 7 6 7 6 7 6 7 6 7 0 0 0 0 0 0 0 0 0 0 1 0 3 3 0 0 0 0 6 7 6 7 6 7 6 7 6 7 6 7 6 7 6 7 6 7 6 7
4 5 4 5 4 5 4 5 4 5 4 5 0 0 0 0 0 0 0 0 0 0 1 0 3 3 0 0 4 5 4 5 3 3 3 3 3 3 4 5 4 5 4 5 4 5 4 5 4 5 
6 7 6 7 6 7 6 7 6 7 6 7 0 0 0 0 0 0 0 0 0 0 1 0 3 3 0 0 6 7 6 7 3 2 2 2 2 3 6 7 6 7 6 7 6 7 6 7 6 7
4 5 4 5 4 5 4 5 4 5 4 5 0 0 0 0 0 0 0 0 0 0 1 0 3 3 0 0 4 5 3 3 3 2 2 2 2 3 4 5 4 5 4 5 4 5 4 5 4 5 
6 7 6 7 6 7 6 7 6 7 6 7 0 0 0 0 0 0 0 0 0 0 1 0 3 3 0 0 6 7 3 2 2 2 2 2 2 3 6 7 6 7 6 7 6 7 6 7 6 7
4 5 4 5 4 5 4 5 4 5 4 5 0 0 0 0 0 0 0 0 0 0 1 0 3 3 0 0 0 0 3 2 2 2 2 2 2 3 4 5 4 5 4 5 4 5 4 5 4 5 
6 7 6 7 6 7 6 7 6 7 6 7 0 0 0 0 0 0 0 0 0 0 1 0 3 3 0 0 0 0 3 2 2 2 2 2 2 3 6 7 6 7 6 7 6 7 6 7 6 7
4 5 4 5 4 5 4 5 4 5 4 5 0 0 0 0 0 0 0 0 0 0 1 0 3 3 0 0 0 0 3 2 2 2 2 2 2 3 4 5 4 5 4 5 4 5 4 5 4 5 
6 7 6 7 6 7 6 7 6 7 6 7 0 0 0 0 0 0 0 0 0 0 1 0 3 3 0 0 0 0 3 2 2 2 2 3 3 3 6 7 6 7 6 7 6 7 6 7 6 7
4 5 4 5 4 5 4 5 4 5 4 5 0 1 1 1 1 1 1 1 1 1 1 0 3 3 0 0 4 5 3 2 2 2 2 3 4 5 4 5 4 5 4 5 4 5 4 5 4 5 
6 7 6 7 6 7 6 7 6 7 6 7 0 0 0 0 0 0 0 0 0 0 0 0 3 3 0 0 6 7 3 3 3 3 3 3 6 7 6 7 6 7 6 7 6 7 6 7 6 7
4 5 4 5 4 5 4 5 4 5 4 5 4 5 4 5 4 5 4 5 4 5 4 5 4 5 4 5 4 5 4 5 4 5 4 5 4 5 4 5 4 5 4 5 4 5 4 5 4 5
6 7 6 7 6 7 6 7 6 7 6 7 6 7 6 7 6 7 6 7 6 7 6 7 6 7 6 7 6 7 6 7 6 7 6 7 6 7 6 7 6 7 6 7 6 7 6 7 6 7 
4 5 4 5 4 5 4 5 4 5 4 5 4 5 4 5 4 5 4 5 4 5 4 5 4 5 4 5 4 5 4 5 4 5 4 5 4 5 4 5 4 5 4 5 4 5 4 5 4 5
6 7 6 7 6 7 6 7 6 7 6 7 6 7 6 7 6 7 6 7 6 7 6 7 6 7 6 7 6 7 6 7 6 7 6 7 6 7 6 7 6 7 6 7 6 7 6 7 6 7 
4 5 4 5 4 5 4 5 4 5 4 5 4 5 4 5 4 5 4 5 4 5 4 5 4 5 4 5 4 5 4 5 4 5 4 5 4 5 4 5 4 5 4 5 4 5 4 5 4 5
6 7 6 7 6 7 6 7 6 7 6 7 6 7 6 7 6 7 6 7 6 7 6 7 6 7 6 7 6 7 6 7 6 7 6 7 6 7 6 7 6 7 6 7 6 7 6 7 6 7 
4 5 4 5 4 5 4 5 4 5 4 5 4 5 4 5 4 5 4 5 4 5 4 5 4 5 4 5 4 5 4 5 4 5 4 5 4 5 4 5 4 5 4 5 4 5 4 5 4 5
6 7 6 7 6 7 6 7 6 7 6 7 6 7 6 7 6 7 6 7 6 7 6 7 6 7 6 7 6 7 6 7 6 7 6 7 6 7 6 7 6 7 6 7 6 7 6 7 6 7 
4 5 4 5 4 5 4 5 4 5 4 5 4 5 4 5 4 5 4 5 4 5 4 5 4 5 4 5 4 5 4 5 4 5 4 5 4 5 4 5 4 5 4 5 4 5 4 5 4 5
6 7 6 7 6 7 6 7 6 7 6 7 6 7 6 7 6 7 6 7 6 7 6 7 6 7 6 7 6 7 6 7 6 7 6 7 6 7 6 7 6 7 6 7 6 7 6 7 6 7